111111111111111111111111111111111111111111111111111
100000000000000000000011111000000000001111111111111
111111111111111111110111111111111101100001111111111
111111111111111110000001111111111000000000000000111
111111111111110000001111111111111111111111111111111
100000000000000000000000000000000000000000000001111
100001111111111111111111111111111111111111000011111
100111111111111111111111111111111000000000000111111
101111111111111110000000000000000000011111011111111
111111111111111111111111000000000001111111011111111
111111111111111111111111111101111111111111001111111
111111111111111111111111111001111111111111100111111
111111111111111000011111111011111111111111110111111
110001111111111000011111110011111111111111110111111
111111111111111001111111110111111111111111110001111
111111111111100011111111100001111111111111111111111
111111111100000011111111100000000000000011111111111
111111111111001111111111000000111111111111111111111
100000000000000000000000000111111110111111111111111
100000000000001111111111111111111110111111111111111
111111111100000000000000000000000000000000000000111
111111111111111111111111111111101111111111111100111
111111111111111111111111111111111110000000000001111
100000000000000000000000000000000000011111111111111
100111111001111111111111111111111111111111111111111
100111111001111111111111111111111111111110111111111
100111110001111111111111111111111111111110111111111
100111110000000000000000011111111111111110111111111
100000000001111111111111011111111111100000000000011
111111111111000000000000000000000000001111111111011
100000000000011111111111111111111011111111111000011
101111111111111111000000000100000011111111000000011
100000000000000000011111111111111011111100011111111
111001111111111111111111111111111000011111111111111
110011111111111111111100000000111110111111111111111
111011111111111111111101111111111111111111111111111
110011110000000000000000000000000000000001111111111
110011000111111111111111111111000011111111111111111
110010011111000011111110000001111000111111111111111
110100111110011000011000111000111100011111111111111
110100111000111111000011111100000001111111111111111
110100100011111111111111111111111111111111111111111
110100110011111111000001111111000000000001111111111
110110011001111110011100111000011111111000011111111
110111001100000000111110000011111111111111011111111
110111100111111111111111111111111111111111000111111
110111110000000000000000000000000000111111110111111
110111111111111111111111111111111110111111110111111
110000000000000000000000000000000000111111110000011
111111111111111111111111111111111111111111111111000
111111111111111111111111111111111111111111111111110